crimeRate,city_idx,total,out_per,total_m,total_w,out_m,out_w,suicide_rate,tax,death,injured,cctv,city_id,city_name,district_name,age,total
0.007215241,1,9904312,0.034,4859535,5044777,165218,171898,19.9,9169412842,376,591,44457,1,서울특별시,서울,합계,9904312
0.006779565,2,2890451,0.0235,1455017,1435434,40224,27626,24.1,1764120424,136,255,8680,2,인천광역시,인천,합계,2890451
0.009765215,3,605619,0.025,304789,300830,8914,6232,22.3,509905893,93,145,2249,3,제주특별자치도,제주,합계,605619
0.002440124,4,204088,0.0219,103210,100878,2755,1716,19.7,328603432,19,24,1848,4,세종특별자치시,세종,합계,204088
0.006199322,5,1538394,0.0124,772243,766151,8933,10147,24.5,585202673,97,143,6356,5,대전광역시,대전,합계,1538394
0.006961296,6,1502881,0.0144,748867,754014,12211,9381,19.8,657682573,97,154,6294,6,광주광역시,광주광역시,합계,1502881
0.006403758,7,2466052,0.0119,1228511,1237541,17292,11990,22.8,1281322518,161,209,14710,7,대구광역시,대구,합계,2466052
0.007550906,8,1166615,0.0256,606924,559691,19321,10539,22.6,788603637,94,134,14178,8,울산광역시,울산,합계,1166615
0.0065827,9,3448737,0.0128,1701347,1747390,26008,18062,24.2,2266450813,178,272,13047,9,부산광역시,부산,합계,3448737
0.007344808,10,1194313,0.0355,602702,591611,22252,20168,22.7,899126663,39,49,6930,10,경기,수원,합계,1194313
0.006593891,11,948757,0.0246,470483,478274,11484,11829,23.4,835364559,40,91,3649,11,경기,성남,합계,948757
0.008570161,12,421579,0.0116,208264,213315,2258,2614,22.3,152223755,22,35,5099,12,경기,의정부,합계,421579
0.006030654,13,585177,0.0161,290592,294585,4634,4791,20.7,302982817,23,36,5097,13,경기,안양,합계,585177
0.007307471,14,843794,0.0293,420867,422927,12775,11981,24.2,350567466,38,45,6422,14,경기,부천,합계,843794
0.005937804,15,338509,0.021,167641,170868,3498,3626,19.8,149652685,13,19,2457,15,경기,광명,합계,338509
0.007971643,16,457873,0.0495,236164,221709,13710,8951,25.7,435922838,60,107,4487,16,경기,평택,합계,457873
0.009063475,17,97424,0.0396,48625,48799,2027,1835,31.7,35755800,10,14,1435,17,경기,동두천,합계,97424
0.009078557,18,747035,0.086,386254,360781,37269,26975,27.6,365417420,55,77,2835,18,경기,안산,합계,747035
0.004710764,19,990073,0.0165,486128,503945,8492,7857,20.1,540176059,64,111,5061,19,경기,고양,합계,990073
0.003671876,20,64817,0.0077,31557,33260,229,271,14.8,67861343,2,2,988,20,경기,과천,합계,64817
0.009391158,21,180063,0.0097,89294,90769,814,931,18,81049020,10,11,1483,21,경기,구리,합계,180063
0.007739431,23,213840,0.0453,109743,104097,4984,4712,25.5,90214025,7,9,2187,23,경기,오산,합계,213840
0.007502634,24,425184,0.087,226111,199073,22268,14739,27.8,281086106,26,39,2910,24,경기,시흥,합계,425184
0.00554737,25,285721,0.0302,142116,143605,4612,4025,17.4,129859392,11,14,2587,25,경기,군포,합계,285721
0.00343494,26,154879,0.0119,77353,77526,1057,779,14.5,87998545,6,8,1973,26,경기,의왕,합계,154879
0.005108565,27,154838,0.0143,78307,76531,1259,958,21.6,209638758,21,40,1610,27,경기,하남,합계,154838
0.003839078,28,971327,0.0222,485568,485759,12375,9167,17.8,872341388,55,88,15,28,경기,용인,합계,971327
0.005419591,29,415345,0.031,212388,202957,8514,4377,24.3,293037561,45,64,1424,29,경기,파주,합계,415345
0.006444884,30,209003,0.0368,106437,102566,4682,3002,24.3,283449812,28,44,3585,30,경기,이천,합계,209003
0.00617154,31,194765,0.0606,100873,93892,7691,4110,28.4,128365677,33,66,851,31,경기,안성,합계,194765
0.004590525,32,352683,0.0581,181687,170996,15505,4971,22.1,274031297,31,55,3759,32,경기,김포,합계,352683
0.004846195,33,608725,0.0679,321376,287349,29609,11718,21.5,1108642371,59,88,6216,33,경기,화성,합계,608725
0.005894714,34,310278,0.0458,160954,149324,9650,4561,29.7,214716423,23,28,2029,34,경기,광주,합계,310278
0.006830495,35,205988,0.0472,106033,99955,7062,2666,21.6,401427173,26,44,2175,35,경기,양주,합계,205988
0.008085049,36,163388,0.099,88047,75341,11879,4303,37.3,86860055,32,59,10,36,경기,포천,합계,163388
0.006631071,37,109937,0.0356,55713,54224,2418,1498,23.2,75695507,8,16,918,37,경기,여주,합계,109937
0.006214577,38,281596,0.0127,138548,143048,1626,1956,22.8,112133540,32,50,1097,38,강원,춘천,합계,281596
0.007964238,39,330854,0.0111,165595,165259,2086,1596,30.2,175600601,34,58,1067,39,강원,원주,합계,330854
0.008076893,40,215677,0.0098,108604,107073,1100,1024,24.2,82877849,21,36,881,40,강원,강릉,합계,215677
0.008697579,41,90255,0.0085,45712,44543,410,355,31.6,31479982,13,20,459,41,강원,동해,합계,90255
0.006678797,42,46715,0.0067,23689,23026,109,206,2.8,11683565,12,18,477,42,강원,태백,합계,46715
0.009518323,43,79846,0.0146,39482,40364,690,474,32.4,26311940,8,11,573,43,강원,속초,합계,79846
0.007998964,44,69509,0.0104,35953,33556,402,323,27,33779662,8,10,474,44,강원,삼척,합계,69509
0.0057392,45,211005,0.0228,107171,103834,2991,1824,22.3,91117723,40,54,890,45,충북,충주,합계,211005
0.005793913,46,136350,0.0124,68515,67835,836,848,31,50781742,9,9,4017,46,충북,제천,합계,136350
0.006840471,47,833276,0.0165,417411,415865,7463,6259,23,499347638,79,134,8283,47,충북,청주,합계,833276
0.005830904,48,629062,0.0351,322793,306269,13527,8532,28,420515813,57,80,5648,48,충남,천안,합계,629062
0.003989713,49,113542,0.0188,56610,56932,1057,1080,20,49966615,21,36,937,49,충남,공주,합계,113542
0.005066174,50,101852,0.0291,52245,49607,2189,775,32.7,46428638,26,35,1027,50,충남,보령,합계,101852
0.005795036,51,319929,0.0538,166820,153109,11148,6065,24.7,294238783,40,56,10,51,충남,아산,합계,319929
0.005076202,52,169221,0.0279,87287,81934,2660,2069,38.3,132014436,37,67,1236,52,충남,서산,합계,169221
0.004281828,53,124246,0.0334,62191,62055,2188,1958,31.6,41125744,33,55,1398,53,충남,논산,합계,124246
0.001503453,54,39243,0.0055,19447,19796,102,112,25.1,11549787,3,4,282,54,충남,계룡,합계,39243
0.004927883,55,163762,0.0389,86801,76961,4352,2023,31,154223008,31,72,18,55,충남,당진,합계,163762
0.005247868,56,658172,0.0101,325652,332520,3122,3511,19,267670330,61,91,4439,56,전북,전주,합계,658172
0.007003325,57,275155,0.0234,141399,133756,4204,2228,20.8,136219537,35,41,2387,57,전북,군산,합계,275155
0.006204366,58,301723,0.0158,151707,150016,2547,2208,25.2,105234887,34,58,2036,58,전북,익산,합계,301723
0.005568261,59,110627,0.0239,54898,55729,1608,1031,31.6,31063780,24,31,1675,59,전북,정읍,합계,110627
0.005888272,60,80499,0.0132,39380,41119,457,603,14.4,22070379,20,29,1414,60,전북,남원,합계,80499
0.005957114,61,84269,0.0253,41856,42413,1410,723,25.3,32656101,29,40,518,61,전북,김제,합계,84269
0.011097009,62,239524,0.0133,120500,119024,1789,1407,34.5,66401476,21,29,29,62,전남,목포,합계,239524
0.007170488,63,273761,0.0161,139565,134196,2967,1442,20.7,159709610,49,71,1528,63,전남,여수,합계,273761
0.006752327,64,265390,0.0076,132329,133061,879,1128,24.1,111814990,41,49,1210,64,전남,순천,합계,265390
0.000680478,65,92582,0.0269,46188,46394,1420,1075,21.1,109580259,30,44,20,65,전남,나주,합계,92582
0.005671195,66,144414,0.0118,74195,70219,880,823,22.2,109762604,25,35,569,66,전남,광양,합계,144414
0.005908512,67,511804,0.0114,259502,252302,3549,2310,23,333389605,52,81,4315,67,경북,포항,합계,511804
0.005512561,68,262310,0.0424,133092,129218,7622,3496,27.2,198003847,68,105,1926,68,경북,경주,합계,262310
0.005860113,69,137540,0.0158,68528,69012,1269,898,22.8,89649870,29,37,522,69,경북,김천,합계,137540
0.006572508,70,168581,0.0089,83170,85411,682,818,24.3,64763412,37,48,2241,70,경북,안동,합계,168581
0.005604702,71,421075,0.0165,216825,204250,4133,2832,26.3,413493919,47,73,2611,71,경북,구미,합계,421075
0.005253235,72,109266,0.0086,54737,54529,416,523,20.3,35805685,15,36,1632,72,경북,영주,합계,109266
0.005016945,73,97669,0.0354,49573,48096,2572,883,26.7,59706391,36,56,6,73,경북,영천,합계,97669
0.004171729,74,98760,0.0104,48392,50368,482,541,34.4,29247990,24,54,988,74,경북,상주,합계,98760
0.005342908,76,278500,0.0304,140493,138007,5332,3140,20.7,148604172,32,45,1250,76,경북,경산,합계,278500
0.00582692,77,1086852,0.0154,554938,531914,11291,5497,20.3,758781088,73,94,1149,77,경남,창원,합계,1086852
0.007400658,78,143771,0.032,73972,69799,3612,991,30,54549961,15,24,1153,78,경남,통영,합계,143771
0.006098062,79,547387,0.0338,281627,265760,14400,4122,24.3,339642006,43,61,2524,79,경남,김해,합계,547387
0.004764286,80,109985,0.019,53943,124506,1157,932,27.6,59968518,22,36,968,80,경남,밀양,합계,109985
0.006441991,81,270879,0.0556,146373,124506,11092,3959,20.8,242501948,14,73,1566,81,경남,거제,합계,270879
